<configparser.SafeConfigParser object at 0x7ff3d8f1afd0>
erst	erst	KNOWN	O
versand	versand	KNOWN	O
werden	werden	KNOWN	O
Liebe	liebe	KNOWN	O
Tekla	tekla	UNKNOWN	O
wir	wir	KNOWN	O
bedanken	bedanken	KNOWN	O
uns	uns	KNOWN	O
herzlich	herzlich	KNOWN	O
für	für	KNOWN	O
die	die	KNOWN	O
Pakelchen	pakelchen	UNKNOWN	O
durch	durch	KNOWN	O
geschickt	geschickt	KNOWN	O
habt,	habt,	UNKNOWN	O
ihr	ihr	KNOWN	O
verdachin	verdachin	UNKNOWN	O
Wesen	wesen	KNOWN	O
ihr	ihr	KNOWN	O
mißhan¬	mißhan¬	UNKNOWN	O
zu	zu	KNOWN	O
lohne	lohne	KNOWN	O
er¬	er¬	UNKNOWN	O
verdienen	verdienen	KNOWN	O
Ge¬	ge¬	UNKNOWN	O
viel	viel	KNOWN	O
tausend	tausend	KNOWN	O
mal	mal	KNOWN	O
Josef	josef	KNOWN	B-PER
um	um	KNOWN	O
Berta	berta	KNOWN	B-PER
sen	sen	KNOWN	O
eben	eben	KNOWN	O
unartig	unartig	UNKNOWN	O
sie	sie	KNOWN	O
kommen	kommen	KNOWN	O
mit	mit	KNOWN	O
Niemann	niemann	KNOWN	B-PER
an¬	an¬	UNKNOWN	O
aus	aus	KNOWN	O
bei	bei	KNOWN	O
Geislers	geislers	UNKNOWN	O
werden	werden	KNOWN	O
sie	sie	KNOWN	O
ihn	ihn	KNOWN	O
bald	bald	KNOWN	O
wieder	wieder	KNOWN	O
herausschmeisen,	herausschmeisen,	UNKNOWN	O
es	es	KNOWN	O
ist	ist	KNOWN	O
halt	halt	KNOWN	O
traurig,	traurig,	UNKNOWN	O
wenn	wenn	KNOWN	O
man	man	KNOWN	O
den	den	KNOWN	O
Mund	mund	KNOWN	O
nicht	nicht	KNOWN	O
halten	halten	KNOWN	O
kann	kann	KNOWN	O
und	und	KNOWN	O
großes	großes	KNOWN	O
Maul	maul	KNOWN	O
hat,	hat,	UNKNOWN	O
für	für	KNOWN	O
heute	heute	KNOWN	O
genug	genug	KNOWN	O
Tausend	tausend	KNOWN	O
herzliche	herzliche	UNKNOWN	O
Grüße	grüße	KNOWN	O
ner	ner	KNOWN	O
Buch.	buch.	UNKNOWN	O
und	und	KNOWN	O
Kuße	kuße	UNKNOWN	O
an	an	KNOWN	O
liebende	liebende	KNOWN	O
Mutter	mutter	KNOWN	O
ich	ich	KNOWN	O
dh	dh	UNKNOWN	O

