<configparser.SafeConfigParser object at 0x7f6eded1afd0>
noch	noch	KNOWN	O
nicht	nicht	KNOWN	O
hin¬	hin¬	UNKNOWN	O
Hetter	hetter	UNKNOWN	O
Paul	paul	KNOWN	B-PER
ist	ist	KNOWN	O
wird	wird	KNOWN	O
aber	aber	KNOWN	O
bald	bald	KNOWN	O
ankommen	ankommen	KNOWN	O
ich	ich	KNOWN	O
bin	bin	KNOWN	O
so	so	KNOWN	O
freudig	freudig	KNOWN	O
Liebling	liebling	KNOWN	O
garnicht	garnicht	KNOWN	O
weiß,	weiß,	UNKNOWN	O
was	was	KNOWN	O
daß	daß	KNOWN	O
ich	ich	KNOWN	O
Liebling	liebling	KNOWN	O
zu	zu	KNOWN	O
schreiben	schreiben	KNOWN	O
Bitt¬	bitt¬	UNKNOWN	O
Zu	zu	KNOWN	O
es	es	KNOWN	O
hälft	hälft	UNKNOWN	O
mit	mit	KNOWN	O
den	den	KNOWN	O
wie	wie	KNOWN	O
Sachen	sachen	KNOWN	O
mitbringen	mitbringen	KNOWN	O
ich	ich	KNOWN	O
überlasse	überlasse	UNKNOWN	O
ge	ge	KNOWN	O
de	de	KNOWN	O
2	$NUM$	KNOWN	O
es	es	KNOWN	O
dir	dir	KNOWN	O
ganz	ganz	KNOWN	O
alleine	alleine	KNOWN	O
Butter	butter	KNOWN	O
sie	sie	KNOWN	O
soll	soll	KNOWN	O
nicht	nicht	KNOWN	O
lieben	lieben	KNOWN	O
mitschicken	mitschicken	UNKNOWN	O
als	als	KNOWN	O
die	die	KNOWN	O
Betten	betten	KNOWN	O
viele	viele	KNOWN	O
etwas	etwas	KNOWN	O
Waldmeister	waldmeister	UNKNOWN	O
der	der	KNOWN	O
das	das	KNOWN	O
ist	ist	KNOWN	O
alles	alles	KNOWN	O
nichts	nichts	KNOWN	O
Tausend	tausend	KNOWN	O
herzlich	herzlich	KNOWN	O
Gruß	gruß	KNOWN	O
und	und	KNOWN	O
Küße	küße	UNKNOWN	O
findet	findet	KNOWN	O
Dir	dir	KNOWN	O
in	in	KNOWN	O
Liebe	liebe	KNOWN	O
deine	deine	KNOWN	O
treue	treue	KNOWN	O
St	st	KNOWN	O
2	$NUM$	KNOWN	O
Viele	viele	KNOWN	O
Grüße	grüße	KNOWN	O
von	von	KNOWN	O
meinen	meinen	KNOWN	O
verwandten	verwandten	KNOWN	O
Gute	gute	KNOWN	O
Nacht	nacht	KNOWN	O
viel	viel	KNOWN	O
Biedersehn	biedersehn	UNKNOWN	O
auf	auf	KNOWN	O
frohes	frohes	UNKNOWN	O

