<configparser.SafeConfigParser object at 0x7f818e106d68>
betrogen	betrogen	KNOWN	O
werden	werden	KNOWN	O
dahin	dahin	KNOWN	O
benanter	benanter	UNKNOWN	O
beklei¬	beklei¬	UNKNOWN	O
ein	ein	KNOWN	O
öffentliches	öffentliches	KNOWN	O
Amt	amt	KNOWN	O
ist	ist	KNOWN	O
nur	nur	KNOWN	O
Arbeiter	arbeiter	KNOWN	O
und	und	KNOWN	O
Gestraue	gestraue	UNKNOWN	O
ich	ich	KNOWN	O
kriegen,	kriegen,	UNKNOWN	O
ehe	ehe	KNOWN	O
er¬	er¬	UNKNOWN	O
mir	mir	KNOWN	O
gleich	gleich	KNOWN	O
kann.	kann.	UNKNOWN	O
Auch	auch	KNOWN	O
in	in	KNOWN	O
Buch	buch	KNOWN	O
alles	alles	KNOWN	O
erzähle,	erzähle,	UNKNOWN	O
weil	weil	KNOWN	O
er	er	KNOWN	O
denen	denen	KNOWN	O
Feld	feld	KNOWN	O
meine	meine	KNOWN	O
hältnissen	hältnissen	KNOWN	O
schlief	schlief	KNOWN	O
nach	nach	KNOWN	O
will	will	KNOWN	O
einen	einen	KNOWN	O
leben	leben	KNOWN	O
brudern	brudern	UNKNOWN	O
daher	daher	KNOWN	O
am	am	KNOWN	O
Bahn¬	bahn¬	UNKNOWN	O
Erben	erben	KNOWN	O
sehen	sehen	KNOWN	O
kürzlich	kürzlich	KNOWN	O
Gruse	gruse	UNKNOWN	O
und	und	KNOWN	O
Mühe	mühe	KNOWN	O
an¬	an¬	UNKNOWN	O
auch	auch	KNOWN	O
alle	alle	KNOWN	O
wirken	wirken	KNOWN	O
und	und	KNOWN	O
verbleibe	verbleibe	UNKNOWN	O
zuer¬	zuer¬	UNKNOWN	O
Bruder	bruder	KNOWN	O
Schnee	schnee	KNOWN	O
In	in	KNOWN	O
17.	17.	KNOWN	O
des	des	KNOWN	O
be¬	be¬	UNKNOWN	O

