<configparser.SafeConfigParser object at 0x7f7830006d68>
Also	also	KNOWN	O
ist	ist	KNOWN	O
er	er	KNOWN	O
das	das	KNOWN	O
sit	sit	KNOWN	O
che	che	KNOWN	O
Ver¬	ver¬	UNKNOWN	O
mache,	mache,	UNKNOWN	O
und	und	KNOWN	O
mich,	mich,	UNKNOWN	O
was	was	KNOWN	O
möglich	möglich	KNOWN	O
ist,	ist,	UNKNOWN	O
nicht	nicht	KNOWN	O
abgelang	abgelang	UNKNOWN	O
darauf	darauf	KNOWN	O
Fraus	fraus	UNKNOWN	O
bitte	bitte	KNOWN	O
ich	ich	KNOWN	O
hin,	hin,	UNKNOWN	O
meine	meine	KNOWN	O
Gelästigung	gelästigung	UNKNOWN	O
warten	warten	KNOWN	O
zu	zu	KNOWN	O
las¬	las¬	UNKNOWN	O
gereicht	gereicht	KNOWN	O
zu	zu	KNOWN	O
entschuldigen.	entschuldigen.	UNKNOWN	O
Da	da	KNOWN	O
wir	wir	KNOWN	O
uns	uns	KNOWN	O
zur	zur	KNOWN	O
gegen	gegen	KNOWN	O
scheit	scheit	UNKNOWN	O
aber	aber	KNOWN	O
es	es	KNOWN	O
mangelt	mangelt	KNOWN	O
mir	mir	KNOWN	O
an	an	KNOWN	O
zuverlästigen	zuverlästigen	UNKNOWN	O
Gekannten	gekannten	UNKNOWN	O
dritte	dritte	KNOWN	O
Meinen	meinen	KNOWN	O
besten	besten	KNOWN	O
dankt	dankt	KNOWN	O
also	also	KNOWN	O
einstweilen	einstweilen	KNOWN	O
in	in	KNOWN	O
voraus,	voraus,	UNKNOWN	O
und	und	KNOWN	O
einen	einen	KNOWN	O
schöne	schöne	KNOWN	O
Hau¬	hau¬	UNKNOWN	O
noie	noie	KNOWN	O
Seidl	seidl	KNOWN	B-PER

